0 0 0 0 0 0 0 0 0 0 0
0 0 0 0 0 1 1 1 11 0 0
0 0 0 0 0 3 0 0 1 0 0
0 0 0 7 1 1 0 0 8 0 0
0 0 0 0 0 0 0 0 0 0 0
