0 0 0 0 0 0 0 0 0 0 0
0 0 0 0 0 1 8 1 11 0 0
0 0 0 0 0 2 0 0 1 0 0
0 0 0 72 1 1 0 0 8 0 0
0 0 0 0 0 0 0 0 0 0 0