0 3 1 12 1 1 0 0 0 0 0
0 0 0 1 0 2 0 0 0 0 0
6 1 12 1 0 1 0 2 1 1 7
0 0 1 0 0 1 0 1 0 0 0
0 0 4 0 0 1 1 13 0 0 0
