0 3 1 12 1 1 0 0 0 0 0
0 0 0 1 0 2 0 0 0 0 0
8 1 12 1 0 1 0 2 1 1 74
0 0 1 0 0 1 0 1 0 0 0
0 0 4 0 0 1 1 13 0 0 0
