0 73 0 0 0 3 1 2 0 0 0
0 1 0 0 0 0 0 12 0 0 0
0 12 0 0 0 0 1 1 13 1 0
4 1 1 2 1 0 1 0 0 1 0
0 0 0 0 1 11 1 0 0 8 0
