0 0 0 0 0 1 2 11 0 0 0
0 0 13 1 1 12 0 1 0 8 0
0 3 1 0 0 1 0 1 0 1 0
1 4 0 0 0 1 0 2 12 1 0
0 0 0 0 0 71 0 0 0 0 0
