12 1 8 0 0 0 0 0 1 12 1
1 0 0 0 1 1 2 1 1 0 1
1 11 1 1 1 0 0 0 11 0 71
0 0 0 0 13 0 0 0 1 0 0
0 0 0 0 4 0 0 1 12 3 0
