1 74 0 3 0 0 0 0 0 0 0
1 0 0 1 0 1 1 1 13 8 0
11 0 0 4 0 1 0 4 0 0 0
1 2 1 12 1 14 0 0 0 0 0
0 0 0 0 0 1 1 12 2 3 0
