8 1 0 5 0 1 1 11 1 1 1
0 3 0 2 0 1 0 0 0 0 12
0 1 13 1 0 11 0 0 0 0 1
0 0 1 0 0 1 4 0 7 1 2
0 0 1 14 1 2 0 0 0 0 0
