0 0 0 0 0 0 0 0 0 0 0
0 0 0 1 6 1 1 1 1 0 0
0 0 0 3 0 0 0 0 1 0 0
9 1 1 1 0 0 1 1 1 0 0
0 0 0 0 0 0 71 0 0 0 0
