0 0 0 0 0 0 0 0 0 0 0
0 0 0 1 13 1 2 1 12 0 0
0 0 0 4 0 0 0 0 1 0 0
9 1 5 6 0 0 1 1 1 0 0
0 0 0 0 0 0 71 0 0 0 0
